QUERY_ID	TITLE	MAIN_CONTENT	TAGS
jeyk2vpg9od4ll	urgent final	finalist kindly note follow instruction final harvester bot formula mention rule book remain direction attach fruit begin tree face yantra clockwise fashion mention rulebook final team get tree inchesof diameter unavailability inch one team advise slight change practice arena open day competition team calibrate iit bombay pin	harvester_bot
je1qcj62ybh60s	urgent task -bonus configuration	participant bonus configuration follow image give configuration pdf file bonus task ignore rulebook rule fruit place clockwise fashion start tree face yantra logo time rule stand hope clear let know issue pin	harvester_bot
jbbrw9ult7r4b4	hardware testing	greeting yantra participant thehardware testingfolder available portal relate document hardware testing folder download shipment page accept acknowledge receive shipment yantra kindly thevideo tutorialprovide record similar video hardware testing end ensure read document properly hardware connection properly switch power supply read instruction give video record yantra responsible fault hardware provide find deadline th december hardware component faulty inform soon possible avoid delay shipment perform hardware testing upload video link portal soon possible extension deadline hardware testing case disclaimer planter bot doubt query relate welcome thank happy learn pin	planter_bot
jlfbcgtqtds2ln	urgent	 partcipate eyrc get certificate want know know merit participation certificate get round get eliminate	transporter_bot
jemgr4j7xxj4lp	accommodation	possible team accommodation campus till march mumbai mumbai frequently want visit place additional charge need pay pay possible campus arrange outside campus inform early possible book ticket return journey thank	harvester_bot
jedrh3xqt2l1jm	score task	score totally base video consider code low quality video lead blink color properly capture mention working think correctly code	planter_bot
je7fpjcgvxy4hj	task submission certificate	 get mail mention nee submit video code tomorrow get certificate get mail night tomorrow holi west bengal collage close tomorrow flex robot collage case video lot hard work project want certificate kindly tell	harvester_bot
je52kyxdtml55r	obscure rule submission	portal say original deadline time original configuration download hour day original deadline incur penalty day according point download task th original deadline fall th february day th th fair yantra let submit task rule mention wrongly portal	harvester_bot
je3y6aw9jun4xq	zone indicator invert plain	 require mandatory stop robot zone indicator invert plain yes specific minimum duration halt	planter_bot
je3tv0w06es6hr	query concern robot position shed	 theme planter bot read pdf provide original configuration task clearly state nursery robot place cell specify robot stop position shed state cell coordinate shed similarly castor wheel motor wheel position shed	planter_bot
je32rf6p13511i	unable demo video	watch demo video portal 	transporter_bot
je32hq5k59c4vc	task document folder	document present document folder py code	planter_bot
je2z7q3pgno4p6	robot movement	robot stop middle run code random point resolve	harvester_bot
je2r7qmcela2q6	print title_slide	 today sunday shop locality close able print title_slide title slide laptop video	harvester_bot
je2ldyb55al64r	important query	valid shoot introduction demonstration separately merge allow reply asap like mention merge kind edit demonstration regard teamid pb	planter_bot
je2ef9hlkaa2qn	introduction video	currently have holiday college member video merge introduction member separately single member leader hold title_slide docx starting	planter_bot
je2copbaqzi4yc	final video	shot introduction shoot demonstration video separately merge shoot video introduction demonstration	planter_bot
je1zw2jp7ix7cm	urgent	believe technical glitch portal task window leave day leave option upload video document code wipe show competition close upload original configuration asap regard pb	planter_bot
je1x93i1b9v5a1	task demo video code submission	"original configuration competition close ready demo video code submit show competition closed""plz resolve issue fasteyrc track je ilju png"	planter_bot
je1shfmxy0z148	final video	 shot video display arena laptop screen time overlay plantation perfectly visible need overlay properly nt arena fully plantation image arena separately	planter_bot
je1sgx4wp5eqy	arena print opposite flex cut glossiness flex	glossiness flex face lot especially colour detection colour marker arena print opposite flex final submission task cut glossine flex urgent reply asap	planter_bot
je1p1oeahlxnq	final video submission	member home holi holiday member introduce task prepare individual introduction second combine	planter_bot
je1otxt4uyt2lo	final video	mandatory member present final video member town okay present video 	planter_bot
je1mwiw0ruu57	picamera working	picamera suddenly stop work state picamera enable import picamera fail connect resource working morning able follow line efficiently suddenly evening stop work try enable disable camera sudo raspi config reboot time go vain submit document code video respectively state disfunctione picamera pb	planter_bot
je1lby141ri521	change speed robot bonus configuration	change speed robot bonus configuration	planter_bot
je1hgbnlp29714	picamera error	img jpgi try capture image line follow capturing image get error morning get error 	planter_bot
je1gj3d6mk57f8	sd card get damage	run bot suddenly sd card stop work try connect sd card computer show mb space lose hour try best come buy new sd card glad provide kind thank 	planter_bot
je17vxin62w3l9	white line sensor work	hello mamsuddenly white line sensor stop transmit light give reading display great kindly suggest	harvester_bot
je14wy1u7vruq	detection vertex number color marker	detect vertex nos color marker formula approx cv approxpolydp cv arclength true true plea pb	planter_bot
je0zvikopwr3b6	code submission	submit code portal give hour download submit video code give th submit code reply hour leave	planter_bot
je0tjfmde9d4d1	float division error	try find center color marker moment continuously get float division zero error get soon possible thank advance	planter_bot
je0g97e1dn55l5	reposition rule	reposition allow submit task video specify penalty	planter_bot
je09rqkp6or5km	evaluation final video	score criterion give rulebook evaluate final video scoring criterion traverse arena detection counting cm able detect shape able overlaywill score negative penalty	planter_bot
je060jgbqg25nn	zi doubt	 zi include null zi ipp blend pz leave right rule	planter_bot
jdnzoe0zkar270	plantation zone	respected madam pz- plantation image small pose little overlay image landscape orientation aspect ratio image large able downsize lose visibility have compromise skewing aspect ratio provide proper visibility helpful insight solve attach image understanding pz- possible mistaken	planter_bot
jdnyg598yyzdw	increase fps rpi	overclock board ghz require extra cooling system try break frame thread work	planter_bot
jdnhjjlgc496pb	battery power robot	transporter botteam want know useanother battery provide power firebirdv actuator servo grip	transporter_bot
jdk58hv5pju5o4	change pick mechanism	change pick mechanism propose task document hope nt id-	transporter_bot
jdk1k0up9t51z0	memory card	use gb class memory card instead class	planter_bot
jdj42m6dpf66bf	progress video submission	able submit progress video exam minor project presentation currently struggle withpath traversal complete colour marker detection image overlay sorry delay vivek soodteam leaderteam	planter_bot
jdiw0a6a5757dj	feedback progress video	respected madam feedback progress video 	planter_bot
jdiurjcnvpx7ey	progression video	id- respect sir/ madam unable upload progression video th feb college internal exam work good pace far complete task disqualification able upload progression video sure complete task soon	planter_bot
jdiqaprzlwg4rh	traversal	analyze plantation zone bot static position lead blink traverse	planter_bot
jdh9vf7ohegj	encoder doubt	pb number pulse revolutionnote encoder different different observation number pulse receive initially slow increase later gradually rectify error	planter_bot
jdfzxcjhntq5q4	issue control bot	have trouble control bot contour detection follow line frame quick processing robot turn track turn try reduce resolution frame rate 	planter_bot
jdf4e26shrj4dy	overlay doubt	sir/ madam detect green plantation image overlay flower respective plantation zone reply asap time	planter_bot
jdd9urqenzg2yd	access individual objecs blender	 write code individual object name move respective co ordinate object point lastly assign irrespective object access individual object name	transporter_bot
jdcz4en46y4nv	feedback progress video	hello receive task result feedback progress video	harvester_bot
jdcwffjigjuq5	code setting crate blender	input user like run script python console text file user input require sequence	transporter_bot
jdckuc52p1z3h2	doubt	plantation image know flower blend mean hard code coordinate	planter_bot
jdbw1zt1ih94jp	overheat	face problem bridge recently start overheat soon connect battery change bridge soon	transporter_bot
jdbsrpd38f66xb	image addition code pi	want know file pi code use example keeping image shape custom create mask image overlay	planter_bot
jdbnn4infzqu	 pi work	 pi work properly light blink use rapsberry pi	planter_bot
jdbj6vq7ut4ko	blender	try robot loc send xbee blender blender stop respond	transporter_bot
jdbagh5oa6i672	doubt	know coordinate pz plantation zone hard code coordinate way	planter_bot
jdba13pzxwo7nk	read image	read image save inside rpi read plantation jpg	planter_bot
jdb2ox02t4j41o	interrupt	share link study interrupt routine rpi searched website fund useful	planter_bot
jdakdighfo633z	raspberry pi	mam work motor code suddenly stop work realise gpio pin work pi get hot try use motor code pin voltage instead pi pls instruct wrong solve want fry remain gpio pin pls	planter_bot
jda2pbthrq96t3	permission update gpio	 pigpio library instal rpiit give error permission update gpio	planter_bot
jda1r9awp3ftn	error run picam module	get error replace picam error say datum receive sensor check connection img wa jpg	planter_bot
jd9pkaxt9ki45y	progress video	exam go able upload video nt complete task submit progress video know late date upload progress video coz exam go nt complete task progress video day work hard submit final task th feb submit progress video affect future	planter_bot
jd99bocrble2fg	delay progress video submission	group need day final submission	planter_bot
jd91idjtccy4hp	suggestion	record uploading progress video share link helpful thank	planter_bot
jd91e2ayn6oo	task	madam robot move path smoothly use webcamera use picam video feed get stuck point bot keep frame cause bot malfunction code remain case processing picamera resolution frame rate olease suggest overcome note kind feedback technique	planter_bot
jd8dyl1ypbrer	error	camera work fine suddenly show error tell error mean	planter_bot
jd64ii4q4mc5ui	encoder motor	encoder motor start malfunction able work	planter_bot
jd5w1lzfmbd3hv	submission video th feb	 respected madam able upload progression video th feb internal examination go college upload video later upload video	planter_bot
jd5m41x2c2l5xh	doubt traversal plucking	consider bot node tree fruit pluck plucking bot right left node tree position follow line time circularly tree follow line follow black line tree	harvester_bot
jd4uzutrmtg4ho	able change motor speed changedutycycle	try altering argument changedutycycle motor speed change keep circuitry connection provide hardware software test move speed facing	planter_bot
jd4mxvtca9042l	change speed motor	safe change value duty cycle obtain different speed arena use additional function pls provide link	planter_bot
jd4lwypxpz32xq	general rule	member present month recover proceed contest member	transporter_bot
jd4lmv90grs6lk	lipo battery power drain rapidly	 time duration char lipo battery charge minute thenaft discharge rapidly minute replace battery mah	planter_bot
jd4ige65q5i34d	picam video smooth	try hard unable smooth video picam video like hang try lot set perfect combination resolution fps nt satisfactory result	planter_bot
jd4bzq9ugpx3a0	end run video	task say till blink video end bot traverse arena	planter_bot
jd460asocko25d	picamera query	low resolution option apart one mention picture take screenshot picam documentation want good choice resolution frame rate process unable correct option	planter_bot
jd42ayc33cy4ev	fan cool	use fan pi fan motor cardboard	planter_bot
jd3kvtgjqy652m	ssh	upload program ssh suddenly rpi stop respond ssh able login pi window start session ssh	planter_bot
jd3fw1hcuge7d1	communication pi firebird	hello provide resource communication firebird pi communication nee	harvester_bot
jd1tt13awyj5k3	expansion slot pin name firebird	explain number expansion slot consider leave number right wrong vice versa	harvester_bot
jd1nek6wuvn3mk	rulebook	get confuse fruit table indicate fruit tree give provide tree table deposition zone table require fruit table 	harvester_bot
jd1jkdr19m16eq	fps video	fps increase raspbeerypi hot somebody tell increase fps	planter_bot
jd0lqx869sv1lc	zone indicator	able follow track completely zone indicator detection check color position cx cy- cx- cy- cx cy- cx- cy- cx- cy- cx cy- cy- black cy- black cy- white program stop motor frame go speed able process pls instruct	planter_bot
jd0lhtrzi8158s	speed	bot follow track completely accuracy speed slow give right changedutycycle similar way increase able process frame correctly pls instruct	planter_bot
jd0g1yl0gio5x2	avrdude	compulsory use avrdude programming firebird	harvester_bot
jczo2qj4gih38p	youtube file	 upload video youtube accord standard give deadline file finish uploading reason get save untitled try uploading get save untitled able edit video paste link video yrc page guide proceed 	transporter_bot
jcz5ondz3nc3mf	upload youtube get error angular bracket allow	 uploaded video yrc hb task progress_video replace angular bracket open bracket let know correction video upload thank	harvester_bot
jcyuehsynew5s	xbee communication	able configure xbee firebird xbee connect adapter work good able transmit data firebird end able way round tb	transporter_bot
jcyr3qx327i4oi	error	screenshot png overcome	harvester_bot
jcylfvjwdd54gu	progress video	possible extend deadline progress video able complete progress video blender	transporter_bot
jcya8b15ip42qb	task	mam submit task propose algorithm change algorith efficient working bot okay mark affect	planter_bot
jcy7zaswida5tk	bge respond	run script serial serial com baudrate command blender stop respond try high version low version occur	transporter_bot
jcxts3v2x9e745	query background plantation image	overlay image pi cam click image background overlay image color marker plantation image zone overlay shape crop total number color marker plantation png	planter_bot
jcxoao83yeh43b	query xbee transmission	transmit datum firebird zigbee module connect pc function uart_transmit call datum transmit multiple time statement main program ignore	transporter_bot
jcxk42zgat428n	progress video	wanna know compulsory upload progress video prepare mention schedule disqualify competition member ill past week depress clarify thing upload day later penalty upload hardware mean blender vise versa task denial disqualify competition want competition planned schedule acco final submission eyrc main schedule complete hold mechanism currently work code guide apologize mistake tb	transporter_bot
jcxav47forl30g	blender python	hello madam try change position particular cube object console window show error obj define mesh object attribute location overcome tb	transporter_bot
jcx75209sig4ey	doubt blender python	python script develop run blender render mode switch blender game engine run play mode press escape key script run get output run script blender game	transporter_bot
jcx4ll761q15zz	reflection shadow image	explain handle reflection shadow flex traverse robot	planter_bot
jcw4e4iu9682bh	block arena	fix block arena vary time evaluation	transporter_bot
jcvyxvaclx125k	blender game engine	render object texture game mode enter play mode texture render	transporter_bot
jcvf9khhki842t	picam	good choice picam resolution frame rate capture clear frame process try option frame capture good process	planter_bot
jcuupzhtjty4cc	bot movement	try compare frame centroid centroid contour max area resized frame color_image frame array centroid contour max area leftt cx cx forward cx rightt leave changedutycycle right changedutycycle use kiya process frame properly instruct	planter_bot
jcul5ep07xs4e3	motor replacement	https //robokits co motor encoder dc servo high precision quad encoder gear dc motor- v- rpm buy motor link provide instructor duty cycle turn slow motor provide kit check rpm stopwatch find new motor buy turn rpm motor provide kit turn rpm search motor nex robotic find http //www nex robotic com product motor accessories/ rpm shaft dc gear motor position encoder html believe exact motor provide kit request instructor confirm soon possible	planter_bot
jcs9q58to9r4sa	raspberry pi work	respect raspberry pi stop work day use light get connection adapter immediately	harvester_bot
jcry05jykrw13r	line traversal	line traversal picam need find contour process image find path traversal find pixel value black present follow path better	planter_bot
jcru7h3n2dd3ru	picam doubt	get follow error try display live video operate like threshold blur etc error get display soon window play video open single frame display logic correct run perfectly laptop camera jpg	planter_bot
jcrg0en5v2y38	stuck vnc viewer screen	get attempt reconnect vnc server message try reboot raspberry pi apply change asap try mobaxterm	planter_bot
jcr6l7s77zc55e	doubt python	import pillow program	planter_bot
jcqh37qjhsptf	result declaration	result task declare	planter_bot
jcqbf3x5rqv607	rgb lead	lead give common cathode lead common anode lead provide link connect led rpi	planter_bot
jcq82mygx4661v	progress video	use ir sensor provide kit objection use sensor apart provide kit yantra	planter_bot
jcop2x2n7zj4h	error opencv	cv imshow work asking rebuild opencv undergoing	planter_bot
jco5lg6mwaw34g	rgb lead	lead give common cathode common anode lead provide link connect led rpi	planter_bot
jcnk5lrbrcd72g	motor driver	use	planter_bot
jcnbuasg87c4wp	encoder doubt	want know perform interrupt routine rpi function inbuilt command search net find good resource	planter_bot
jcnbsdd6sxg4ce	picamera query	give camera feed frame rate resolution slow capture properly cause robot fail smooth movement way improve performance camera	planter_bot
jcn15lrtff6d4	setup communication pi firebird	 pi image processing establish communication pi firebird return value firebird	harvester_bot
jcm0qp1hzgm68x	use component	use spare part unused stuff like toy similar bot	planter_bot
jclu2iizrfu2o9	doubt	circuit hardware test ressistor perf board connect channel quad encoder require think channel cknnecte rpi reply asap	planter_bot
jclrys0nzz2zh	rpi heating	broadcom rpi get heat high temperature simply connect power bank work fine want sure natural notice high temperature google find heat sink pls tell ok buy	planter_bot
jclircusovg5f4	planter_bot	pb theme team suppose place cm zi designate cell paste arena permanently cm zi configuration different different stage competition use mask tape double sided tape avoid displacement run go	planter_bot
jcld0h4r5aa4xb	rpi query	application like contour detection threshlode valid picam yes share example perform webcam sure rpi camera nt want damage unnecessary thing	planter_bot
jckfzargbcu563	interface query	way run code laptop send output signal raspberry pi control motor want check code laptop build webcam control motor instead picam testing pls	planter_bot
jcjtv3exr0d2vt	doubt usage extra component	refer rulebook provide allow use extra component sensor actuator provide kit refer say use motor provide kit clarify suppose use use	transporter_bot
jcj2ibpe5w2z0	task	result task website specifie date task th feb true website update let know	planter_bot
jchgqt2vemr2iq	follow black line	width line give flex compare distance white line sensor time line come white line sensor condition	harvester_bot
jch8uh8ye2249q	step	submit task step need wait task need start implementation robot	planter_bot
jch5dj8iou06xr	damage stepper motor need specification	stepper motor start function abnormally think damage try adjust rotate structure know stepper motor buy	transporter_bot
jcguqoq3lcl6yl	python module	madam make program follow modular approach separate module routine source file clean simple know format yantra expect task okay continue modular approach define separate function single source file thank pb	planter_bot
jcgj86lyabp1v5	task result	respected madam submit task time submitting show result page say task submit kindly verify thank	planter_bot
jcgbwcjil055rw	testing	accidentally comment imshow line picam testing live stream live video correctly write avi file show current hw video upload correct pls instruct need upload hw testing video 	planter_bot
jcg4wya8nw4le	pi camera working	camera enable properly connect try possible work thank advance	planter_bot
jcfqla0470m4su	picam stand	refer ecommerce link buy pican stand iam unable	planter_bot
jcfnjmftw6hfz	motor driver get damage	hardware testing planter bot remove power bank motor leave rest connection motor driver get damage	planter_bot
jcf3n1ec9k811y	chassis dimension	specify dimension material chassis buy readymade market	planter_bot
jcet53epi0f7je	querry	tell error mean	planter_bot
jcer8skd8cx5mf	robot dimension doubt	limitation dimension robot planter bot yes maximum dimension height	planter_bot
jcenqiuq58x29f	opencv cmake issue	get refer pic attach cmake follow step set raspberry pi proxy setting follow link https //raspberrypi stackexchange com questions/ /how set proxy raspberry pi raspbian os linux command li https //www raspberrypi org forum viewtopic php http //www instructable com add local internet proxy setting raspberry-/ configuration complete file generate end cmake sudo clean happen properly doingsudo reach give error https //drive google com file d/ eqssit cy qauruent lpb gjxdwext /view usp share thank	planter_bot
jcecfozeles631	have doubt task	madam submit task th november show submit task submit task yesterday mistake	planter_bot
jccwllm2hqd1fp	task result	expect task result	harvester_bot
jcc8uchr3j1c0	hardware testing	madam motor testing get error picamera code provide error attribute error module object attribute videowriter fourcc try lot get error lead picamera glow unable capture video	planter_bot
jcas04qhc6f2gj	interrupt service routine running	point resource read pulse quadrature encoder interrupt raspberry pi	planter_bot
jcaovgyu81o2vy	get attribute error run code picam py	attribute error module object attribute videowriter fourcc solve try afternoon get solution	planter_bot
jcampuqbr13yd	get error run picam py	import error module name cv error run code instal opencv completely try work	planter_bot
jcamp5fmzrr3ma	query	madam portal see grade policy new tab read information tell task apply future task conduct 	planter_bot
jcaikaqt6dk341	 li ion battery	know battery fully charge	planter_bot
jcafqrgrsqc49x	task submission	tb- madamwe upload task file january eyantra website write late folder receive deadlinetue january pm consider upload update file add answer unfortunately file upload jan want confirm file upload deadline consider uploaded deadline eyrc track jcafnbn dpra jpgeyrc track jcafnvmkkadn png	transporter_bot
jca6jvhs8qa5e9	leave define code	run motor test py error leave define code fix issue	planter_bot
jca4sasdvpdk	task submission late sec	 hello upload task penalty impose	transporter_bot
jca0z24t9wy5jr	task submission	give result task submit submit task flex image upload deadline tell issue	planter_bot
jc9gki4q3w35hn	delay hardware testing upload	unfortunately unable upload hardware testing video today technical reason assure upload video tomorrow th january fail accept sincere apology delay cause	planter_bot
jc93iumf9x8hw	resource	able acess image processing resource resource section resource fire bird python tutorial image process open image processing tab error attach screenshot error show screen	harvester_bot
jc92o0lb4di67y	task submission	madam upload task folder twice late folder upload folder consider penalty	planter_bot
jc8xicoq380793	upload format	 uploaded zip folder time zip folder upload file pdf format docx format query cause penalty	harvester_bot
jc80a41lasp6rl	delay upload task	mam get kit yesterday college holiday complete testing pi cam face difficulty motor test maybe circuit connection provide day allow find fault upload hw testing video soon possible successfully submit task deadline	planter_bot
jc805pnb2rv3hn	submission task	submit task jan forget save word document send send answer try upload say upload folder accept folder	harvester_bot
jc7zn89y5n65uv	submission	constant net hostel able submit task pm take additional time submission submit task kindly excuse time	planter_bot
jc7zjye4y2t3lw	late submision	submit task second late deu lack internet consider	transporter_bot
jc7zecwyi8j2zv	upload task	madam uploading zip file moment haste zip file pic task document file submit task applicable penalty 	transporter_bot
jc7za1yt2j65i	allowance minute submission task	madam constant internet hostel unable submit task allot time request allow extra minute upload task aituation take consideration penalty excuse thank	planter_bot
jc7z1rlcxot269	submit folder change	madam save folder task zip upload portal wen download verify submission find file change ozfn bu pb zip issue theme planter bot	planter_bot
jc7vngybfxd74l	use multiple flowchart describe sub routine	use flowchart sub routine show main flowchart	planter_bot
jc7tt0f1wwy40l	picam error	picam video show error	planter_bot
jc7tpgqkb8q3i7	answer file upload	 release task download task file time read_me file tell converttask implementation_analysis docx pdf file upload today download task download option read_me pdf show save ittask implementation_analysis docx answer upload guide format answer submit	planter_bot
jc7rscu6a48di	urgent task	upload task successfully provide image document ans arena image require addition provide image folder instruct require edit okay	planter_bot
jc7plgn3xqg3ny	rpm motor	hello want ask way find rpm wheel pwm supply	planter_bot
jc7ohpgq60i6kk	opencv cmake error	make build folder write follow command sudo cmake -d cmake_build_type release -d cmake_install_prefix /usr local -d install_python_examples -d opencv_extra_modules_path ~/opencv_contrib- /modules get error configure incomplete error occur get error try cmake fatal source build allow create separate directory build file get error instal libtbb dev library say package libtbb dev installation candidate advise thank	planter_bot
jc7myh7x9rv38w	motor run test	run motor backward direction motor rotate similar run motor forward direction motor run	planter_bot
jc7i55llu8216a	error run picam py file	run picam py file raspberry module cv plzz fast	planter_bot
jc7i1xw0i875j5	instal opencv	sudo cmake -dcmake_build_type release -dcmake_install_prefix /usr local -dinstall_python_example -dbuild_examples -dopencv_extra_modules_path ~/opencv_contrib- /modules run commnad error- configure incomplete error occur	planter_bot
jc7fsh7z9f10h	position sharp ir sensor	change position sharp ir sensor fire bird	harvester_bot
jc7ddwxmp1h18y	doubt field	que arewe suppose design robot traverse real field consist cliff hill road etc instead arena able traverse arena	planter_bot
jc7bdr4jvj45x	arena	gum fix zone indicator arena till aware remove zi fix transparent tap	planter_bot
jc6ov5h6syu5yi	arm mechanism change	allow differ mechanism arm provide answer task question need	harvester_bot
jc6h7p4cn9w3hg	difference question	explain difference question tell detect path st question traverse path nd	planter_bot
jc6eipoos643t	flowchart	attach different pdf contain flowchart	planter_bot
jc6czfyuj7x46c	quad encoder	unable detect output encoder channel gpio pin pi observe cro fine try pattern rpi show random pattern	planter_bot
jc655rq6dv2js	task doubt	mean overlay image seedling image plantation field plant seedling real field right planning traversal technique case consider real field case need overlay image cause actuator need depend case choose	planter_bot
jc64wzskkyu61l	terrain traversal	competition terrain like arena flex mean hill terrain bumpy use suspension terrain 	planter_bot
jc64txstizj56g	overlay doubt	need output image frame overlay traverse arena competition final overlayed output image generate	planter_bot
jc64n9vdc192k1	upload query	 suggest upload zip file mb file mb uploadded give error check recieve file recieve reduce size degrade pixxel value photo	planter_bot
jc64gfh37atz3	file upload transporter bot	upload form ask zip file file include apart document pdf format question ask arena blender image embed document	transporter_bot
jc5ta6lw8c45xf	stepper motor program	make video rotate structure rotate rotate structure algorithm give rulebook include xbee communication	transporter_bot
jc5qfvw4xjb4zn	doubt flowchart algo	use separate flowchart explain path traversal overlay algorithm messy single	planter_bot
jc5mt1m125xmt	task file doubt	 save text file format pdf extension mention read file simply say save file editing	planter_bot
jc5mrfk8vxo23u	doubt task submission	madam read file submit task zip folder name teamid>_task use eyrc simply pb different task express different manner	planter_bot
jc57vm0h8gr69i	rulebook doubt	section table large medium small orange section table size count column orange small orange give typo table relate table follow send picture arena	harvester_bot
jc4un21ybpo2rr	scale fruit position sheet printout use inch outer dia pipe	use inch scale fruit position sheet printout use right use inch dimension fruit position sheet fill gap white sheet	harvester_bot
jc4qopo0p6z6j4	task 	selection process task binary task	harvester_bot
jc4nuuea21t6fq	component	allow use component like sensor etc apart give eyantra	planter_bot
jc4mjwweo2347f	task doubt	arena give sample arena mean shape path position terrain	planter_bot
jc4i8av8lgk4ok	zone indicator sticking	suppose stick different zone indicator gum flex place flex	planter_bot
jc4hfd4mekczd	answer query	question number upload image delete text blue color table final submission leave way	planter_bot
jc4eybv92w5ds	picam case rpi case	allow use protect rpi use planter bot	planter_bot
jc4blt5fg482bt	flowchart question	 flowchart question draw single flowchart later explain function seperately explain function flowchart	planter_bot
jc4auc14wia58s	task question doubt	friend explain question detect explain blue triangle hardware mean unable understand question	planter_bot
jc3pdglwxut3ax	submit task folder available eyantra portal	madam unable locate task submission folder eyantra portal lose data laptop unable recover send task submission need task theme planter bot	planter_bot
jc300hk7y7f4fa	error line width flex	flex line width error cell size cm cm know error occur change give pdf	planter_bot
jc2z7ijpu2a3ho	query overlay question	question mention score provide overlay total total score general need time take information mention rulebook penalty give inappropriate overlay penalty mark deduct mention mark correct overlay image consider penalty	planter_bot
jc2z2no5khh47x	query	mention leader college	planter_bot
jc2sp6wzv7d4yu	power bank	need place power bank planter bot	planter_bot
jc2e388rvtai	use ir sensor planter bot	 want line follower planter bot theme ir sensor provide eyantra use sharp ir sensor make line follower need use image processing path detection	planter_bot
jc28n7adqa5o4	preparation arena	stick color marker zone indicator permanently flex	planter_bot
jc25uwt9p3m6vh	screw stud	provide stud inch need use inch use extra screw stud instruct	planter_bot
jc25ovlda9142n	castor wheel	support weight motor use astor wheel instead instruct	planter_bot
jc1yyhqbuqn2bs	use extra led	use extra led	planter_bot
jc1ynpjt5lq6gk	chase	chase gic metal sheet take care damage arena okay instruct	planter_bot
jc1yn9dkjrv6aj	chase	chase gic metal sheet take care damage arena okay jquery lease instruct	planter_bot
jc1yhoxb6yi42b	use extra motor	use extra motor addition provide yantra rotate camera specify	planter_bot
jc1y1niwmju6z4	task	 madam question mean elaborate	planter_bot
jc1xy3r54rc5rn	task doubt	 madam question specify algorithm detect end run general end run determine ie ip terrain rgb circuit blink sequence end run	planter_bot
jc1t7r642ky2p7	threshold wls differ	threshold value white line sensor change brightness room suppose threshold standard environment threshold	harvester_bot
jc1r17lhiv1tw	task implementation	mean identify marker image processing use sensor clarify	planter_bot
jc1mzqdvmi62lt	task question doubt	 madam color marker present shape circle square triangle rgb color combination	planter_bot
jc1kox40d04x6	task question query	 madam confused question unable understand properly suppose choose picam answer specify pro picam con webcam way mention pro con write	planter_bot
jc1jzo4sf1e4a2	task doubt	 madam confusion question question little bit detail	planter_bot
jc1i79n1j6h4gr	motor specification	 madam want know motor specification like rpm current rating specified motor unlike component specification write	planter_bot
jc13fck4der57w	doubt algorithm design	couple little doubt algorithm design grateful solve permit change algorithm line realise want change work question mention list possible function specify word limit mean elaborate function text form outside flowchart separate flowchart function	planter_bot
jc11gvgor0q2r3	small doubt task implementation question	follow question robot traverse field represent arena give rulebook answer consider real life interpretationsof arena eg hill road cliff road etc present answer mention line follow technique robot implement similar question follow explain use picam decide course traversal explain detail use mount picam sense environment associate theme	planter_bot
jc0xbx0x7dprl	suppose write question	eyrc track jc xbe xltx jpg	planter_bot
jc0uqpjt36q56p	able enter raspberry pi	able log raspberry pi default password userid check ssh status active terminal shantanu@shantanu thinkpad ~$ ssh pi@ ssh connect host port route host terminal ssh service openbsd secure shell server load loaded /lib systemd system ssh service enable vendor preset enable active active run thu ist ago process execreload /bin kill -hup mainpid code exit status /success main pid sshd cgroup /system slice ssh service /usr sbin sshd -d solve	planter_bot
jc0ns4497idgj	robot make query	madam want know time robot th january complete bot th january	planter_bot
jc0ijb3k7mt2eq	explain	leave gpio pwm motor right gpio pwm motor leave start right start left changedutycycle right changedutycycle	planter_bot
jc0gcswguvh67c	testing	mam exam st december get kit query helpdesk reply holiday able kit th jan submit hw testing video member present area college 	planter_bot
jc0bmx23nyd6ya	pickup point blender	change need pickup point blender game create accord task change	transporter_bot
jc08kvgis8w1mb	task chasis query	maam contruct chasis plywood use readymade available online 	planter_bot
jc02sav1ept2fv	solve	screenshot png	harvester_bot
jbzzszosjq60z	opencv installation	get permission deny run cmake command command like rm -rf build	planter_bot
jbzxd9qt3wq484	communication blender interface firebird	tell wether action robot blender perform firebird copy way firebird blender robot precisely want know direction communication blender firebird zigbee theme transporter bot	transporter_bot
jbz7lk3yqn4ok	picam doubt	picam capture video fine good frame rate rapid movement capture smoothly picture quality like mp capture frame picam operate manner	planter_bot
jbz3ckuztpv4cu	query software hardware testing video	mail acknowledge receive shipment upload software hardware testing video semester exam end th december consequently leave home city college kit ship college college restart th january receive kit able hardware testing upload image arena print portal december	planter_bot
jbyrujmflyp1qu	picam fps	thecode provide eyantra hardware testing generate video feed fps video low capture quick movement provide solution increase fps picam	planter_bot
jbyp7gn3hby3ch	use sensor	allow use sensor component build bot task implementation pdf question number mention use sensor	planter_bot
jbykjsq1bni7bv	task doubt	prepare arena rule book answer question town document task right thing hardware programming task inform asap	planter_bot
jby83g7j5c97pe	cv	pi@raspberrypi python picam py run code error see opencv instal traceback recent file picam py line module import cv importerror module name cv	planter_bot
jbxvpjshbaa60p	task doubt	allow use servo task want attach servo pod camera toh deg view require use ir sensor planning use extra motor wheel stability allow list mention 	planter_bot
jbxu19abeec4p5	confusion question task attach final blender interface image	question mention depict scenario blender interface scenario depict farm pickup point crate truck design blender image consist real farm crate truck earlier task give fig rulebook show block rotate structure	transporter_bot
jbxjb9gxm0l2lq	hardware malfunctioning	 tested hardware th december picam work informed matter mail deadline thing replace	planter_bot
jbwz45d9oy64ir	blender	want know blender arena flex sheet change old file start blender game good	transporter_bot
jbw2egr9vy5pr	stepper motor	stepper motor working expect step motor work properly heat lot connect wire driver board heat lot try motorwith standard code arduinoide	transporter_bot
jbvt7yrlhv64v8	task doubt	dimension track competition like length invert plain line width stuff	planter_bot
jbvp28d1fczqu	video upload doubt	video quality fine testing https //youtu fk zh yuhu	planter_bot
jbup065enz3180	video upload	madam record video good quality have size mb youtube upload video clear suggest happendend link provide https //youtu rspfuczpe	planter_bot
jbuhgt919yf63f	doubt seedle color marker	pz cm color shape blue triangle red circle blue square red square arrangement possible combination	planter_bot
jbugti09g361f2	testing video	upload video hardware software test video min size mb quality gud https //youtu ov ysy ygnm okay upload link instruct asap	planter_bot
jbtt43h3ipk4b7	serial terminal	use serial terminal receve usb gui fb able receive datum serial usb connection know use serial termial like like arduino serial monitor send receive datum usb atmega like jumper set go hardware manual give face receive data serial terminal rx lead blink send data com port tx lead respond thank	transporter_bot
jbt6i500x9w1zw	error picam	maam time use command raspistill -o image jpg error unable second testing 	planter_bot
jbt1y1dl1sm39h	query	madam following change testing connection breadboard instead prototype board provide different set wheel connect motor shaft shaft nut available fit wheel tight come motor start different lipo battery rating avoid usage dc jack connection battery come cinnection perfectly fit bridge motor driver extra equipment change okay	planter_bot
jbsxsssd16jql	run picam py	run picam py file throw error nt run	planter_bot
jbs9zolp5ufnk	liion battery pack	able figure use battery pack dc jack socket post connection pin diagram	transporter_bot
jbs1lcjczlo67f	hardware testing video	instruct video eyrc pb w_teste correct mention shipment recieve eyrc pb w_teste instruct soon possible	planter_bot
jbrusmjr51l7mn	hardware testing video	mam get raspberry pi motor shipment thing motor working get heat hardware testing video show work exchange port motor interchange video go min upload instruct pb	planter_bot
jbro40nu6zk22w	error opencv installation	follwe step perfectly get opencv installation	planter_bot
jbrk53o0uft228	motor working	 motor work heating maybe short circuit tell soon possible repair	planter_bot
jbrj7bswpp2km	fatal error boostdesc_bgm file directory	sudo build directory get error--- /home pi opencv_contrib- /modules xfeature src boostdesc cpp fatal error boostdesc_bgm file directory include boostdesc_bgm compilation terminate compilation cmakedownloadlog txt	planter_bot
jbrgmiw4ov4df	make zone indicator plant zone	cut use mention strip zone indicator instruct	planter_bot
jbqwj2u5nn86p	hardware testing fault	transporter bot firebird wheel rotate forward direction post bfore change driver persist white line sensor lead glow video upload linkhttps //youtu be/ qvkd nlia kindly reply soon possible hardware testing deadline tomorrow	transporter_bot
jbqwgjf2mjy290	hardware fault	 firebird bot give wheel move forward direction change motor driver chip new work white sensor properly follow fault show video link https //youtu be/ qvkd nlia	transporter_bot
jbqrg2wqugv38y	hardware software testing video time limit issue	run picam code raspberry pi take considerable time generate output video file take place ssh command result final video min mention testing folder file need limit video limit min adhere rule give trim video time picam collect input frame reduce video time min upload go cause problem video less time use vnc connect raspberry monitor keyboard control directly	planter_bot
jbqq721d1hd9	hardware software testing	madam recieved shipment late wo nt able submit testing video th ie tonight extra time task day result negative marking disqualification specify 	planter_bot
jbqlwztsj1j6pt	opencv installation	installation opencv error occur make cmake file configuration incomplete error occur	planter_bot
jbqfgrtfkjw6zz	load operating system	use etcher select image file flash error file try access exit	planter_bot
jbqc81vxnf77n6	doubt submission	technical issue submit hardware software testing video tomorrow cause	planter_bot
jbq7unct2y9689	use power adapter	confirm hardware testing week today suddenly power adapter charge stop work use power adapter specification v/ amp	transporter_bot
jbq53h2711m4fv	hardware testing video date	date submission hardware testing video	planter_bot
jbpzh8b7hvc3xv	ssh doubt window	way apart mention link give pdf ssh pi wifi link specifie download software stuff easy way	planter_bot
jbpyz13e5sp4j9	hardware testing video doubt	hardware testing video upload youtube unliste video planter bot	planter_bot
jbpg593h4kr5fy	hw testing video sample	youtube sample video hardware testing clamp attach motorsby screw nut kit provide contain stud screw nuts suppose connect clamp motor perfectly work thing leave attach clamp okay video temporarily record attach clamp motor 	planter_bot
jbpbbi7b7bd37i	camera working	enable camera show error camera enable try online suggestion vain	planter_bot
jbp983zm1992bm	static dynamic resize overlay image	kind resize overlay image expect program static resize okay matter cm individual overlay image flower size require work dynamic resize plantation zone need cover overlay image	planter_bot
jbp8t0j86bw57s	csv file rpi	rulebook mention csv file provide index robot automatically need read csv file wifi manual input value require	planter_bot
jbp8ppwbsyd1xi	chassis dimension	precribe dimension chassis robot ask question page chassis design	planter_bot
jbp8mvn01ps19y	use extra motor	allow use extra motor rulebook mention explicitly permit use extra wheel	planter_bot
jbp6oj5z7jg13q	urgent ssh	connect pi wifi ssh following step download raspbian os img file flash memory card etch connect sd card pi booting booting reconnect sd card pc pendrive bootable puppy linux boot usb start linux option sdf sdf sdf boot partition sdf external partition open sdf different folder show etc mnt etc path show mnt sdf mnt folder create folder sdc sdc sdc folder blank file name ssh go etc folder wpa_supplicant folder copy file wpa_supplicant file paste make sub folder sdc folder sdc folder etc folder wpa_supplicant folder folder paste copy wpa_supplicant conf file open wpa_supplicant file write network ssid pg psk pg hotspot mobile password original etc folder copy dhcpcd conf file sdc folder etc folder paste connected laptop wifi name pg check ip address show ip address gateway open dhcpcd conf file add follow line interface eth ip address router address domain_name_server interface wlan ip address router address domain_name_server save close file takeout sd card connect pi wait minute boot open mobaxterm click ssh write host ok time give connection time tell wrong step plese instruct soon possible submit software /hardware testing video	planter_bot
jbp4a83wmca5t1	power rpi	madam documentation rpi power source power bank offer option power option	planter_bot
jbp0wooo4825g	format sd card	format card show error disk write protect mean remove	planter_bot
jboykjij9t42xz	hardware rpi shutdown eyrc	connect circuit give hardware software testing folder rpi keep get shut thought lack sufficient current supply counter give external power supply check connect ground rpi ground supply short advise	planter_bot
jbot5r7uhuc6lr	 arduino nano functionality	arduino nano provide work arduino uno okay 	transporter_bot
jboldc23lk247z	task doubt	zone indicator arena black tape material specify material directly place color marker track paste thermocol lye ground	planter_bot
jbol9um4fm73id	rpi query	videocapture command open cv capture frame picamera work connect external usb camera	planter_bot
jbo54uwbn9p5m7	 instal opencv	face instal open cv resolving	planter_bot
jbnq8lt32vdia		file get test check frame rate video file task email abhushanadhikarijoshi@gmail com thank	planter_bot
jbnnx5g6u2p4tb	rpi query	perform image processing rpi opencv link tutorial learn command command task capture video stuff	planter_bot
jbnmfpj5gqd7as	use dc jack socket	hardware testing video dc jack socket possible connect wire video show gnd wire go pcb circuit exactly connect connected -ve terminal battery	planter_bot
jbnkiznf5ea6rc	faulty encoder motor	 testing encoder feedback motor find encoder motor give proper linear value give gibberish value try change jumper wire allocate set gpio pin run luck email helpdesk communication date december pm believe hardware grateful regard	planter_bot
jbniyg4nz2nr8	hardware failure	test hardware robot burn usb gui hex file stk avr boot loader show timeout error time try burn code firebird gui software able control buzzer bot motion test robot time follow problem persist value sensor white line sensor ir sensor sharp range sensor display software ir proximity sensor work middle sensor white line sensor array work try remove insert connect cable persist instruct record video show video link https //youtu fjujhdodkak unable conduct test instruction refer post kindly look issue tell solution soon possible 	transporter_bot
jbni36qr8vt10t	task	actually upload task file give	planter_bot
jbnbv80jmkx5t4	sudo apt upgrade	error face rectify eyrc	planter_bot
jbnbag3ljmd5vp	shipment delay	madam shipment deliver college shall 	planter_bot
jbn4mv7j8my2n	firebird	 firebird charge give beep sound glow red lead accord manual sign flow current charge video link https //drive google com open yg -s -rc nvhd hhdkl tlqyzvq buflaex	harvester_bot
jbn1k1785el3kb	flower	 flower give require work	planter_bot
jbmh79ozher2ld	picam code	run rpi mobaxterm pc	planter_bot
jbm75xzjbwu45q	task doubt	task question assume parameter exclude give parameter	planter_bot
jbm4ni0jfos40g	mobaxterm	connect	planter_bot
jbm4e8yhhue286	hardware assembly	connect clamp bcz screw provide shipment large provide hardware assembly video backlash connect shaft attachment remove black screw shaft shaft attachment shaft provide solution provide	planter_bot
jbm26m2jf7d3e9	picam py programe get warning	run good run picam py programe show warn instruct overcome 	planter_bot
jblxwy3b7ka5e6	default component	 ckt get default capacitor case capacitor break solder instruct	planter_bot
jblxt1khm67643	ssh	difficult connect pi wifi ssh link provide explain clear provide well way connect contain image easily trace instruct	planter_bot
jblxfynqc7278d	line follower	line follower bot picam easy able traverse arena perfectly	planter_bot
jblwagxm7m72an	use component provide kit	point section planter bot rulebook permit use additional wheel shaft clamp etc doubt etc include old rulebook use extra motor allow allow use extra actuator	planter_bot
jbltgu3vxbx7g9	picam properly workingt	 follow able capture picture picam try open give error local machine open give error	planter_bot
jbl2mbh9rmn3dj	warn run code picam py	run code picam py get warn terminal warning video warning error retrieve accessibility bus address org freedesktop dbus error serviceunknown org bus provide service file eliminate warn screenshot warning give	planter_bot
jbkysjkfysn103	get code run sudo command	 i'am get follow output mean run sudo command normal error	planter_bot
jbkxg7input7af	shipment query	madam shipment recieve college few day likely declare holiday christmas celebration 	planter_bot
jbkaqnoupgl6yt	wifi connection	see video link connected rpi pc wifi connect rpi wih pc wifi instruct give tutorial	planter_bot
jbka82dri2h1dk	error gui testing firebird	 eyrc testing motion control robot gui testing software robot work forward right direction backward leave direction speed left motor compare right motor robot move require direction solve request short video link video error gui testing firebird video firebird bot work forward right direction backward leave direction speed leave motor compare right motor bot move specify direction solve thank advance	harvester_bot
jbjh9re5a5g4vr	value obtain leave white line sensor matching expect value	know firebird white line sensor underneath testing bot sensor find provide complete black surface white line sensor sensor equal analog output white line sensor value sensor give significantly less analog value kindly look drive link confuse normal issue possibly lead inaccuracy link https //drive google com open jaa pluw xv -pzijotjzt t_usr	harvester_bot
jbjbn37xikc3uf	opencv installation rpi	execute sudo cmake -dcmake_build_type release -dcmake_install_prefix /usr local dinstall_python_examples -dbuild_examples dopencv_extra_modules_path ~/opencv_contrib- /modules build directory configure incomplete error occur show sudo clean perform dependency instal properly method instal opencv	planter_bot
jbj9qtgda3g2xj	picam preview visible software hardware testing	run command raspistill -o image jpgafter configure picam enable able preview image terminal light switch picam image save sd card attached image list image jpg save	planter_bot
jbj1v2sn9j43tw	ir sensor	ir sensor leave firebird bot work project bot replace	transporter_bot
jbiy25xqeau6yr	datum recieve picamera	software test script throw error second run try image raspistill -o cam jpg throw error mmal datum receive sensor setup pi exactly instruction check connection red lead camera glow script run blank zero size video image save	planter_bot
jbi8qncs8it3xg	face opencv installation	follow instruction end face instruct	planter_bot
jbi5qqauuwo2cr	connect rpi wifi	try method hw sw test documentation raspberry pi get connected wifi need	planter_bot
jbhgtnaaiou4ix	raspberry pi resource	receive raspberry pi kit receive resource study programming raspberry pi doubt- connect raspberry pi fire bird need connect web camera robot	harvester_bot
jbhg9afq7oe26r	question task	sample arena provide table rule book different number color marker give suppose follow use number eyrc track jbhg eevpt png	planter_bot
jbhdvfbzvxu1oz	task result	 able task result	planter_bot
jbgtvjt5j581fy	hardware fault	tb have issue test robot observe gui robot leave wheel rotate backward direction youtube link https //youtu onog ir sensor show proper value show randomn value vary obstacle distance sensor value increase object bring close youtube link https //youtu ncdqyjfhejk white line sensor work fine instruction	transporter_bot
jbghvrya85k51y	kit	mam get kit professional courier send mumbai inform call say ask sender send instruct 	planter_bot
jbggjtb3q2683	harware testing video tutorial	planter bot theme hardware testing video tutorial youtube	planter_bot
jbgfwevfzhl15q	use	uploading youtube video hardware software test suppose use originally receive write box aware	planter_bot
jbg66wcoi9b195	track query	madam tracking detail show result day get update simply take time deliver theme pb	planter_bot
jbg1guunssh3qw	rule book available	rule book task available show rule book come soon receive bot planter bite 	planter_bot
jbg02mp97ukv	task doubt	directly edit docx file give answer question provide later convert pdf start fresh file answer answer proper marking	planter_bot
jbfko88zsl24z7	shipment kit	madam receive bot kit look	transporter_bot
jbf14xh8ek25d0	shrap sensor	 bot contain sharp sensor accord hardware manual customization theme mean theme transporter bot require sharp sensor mention communicating gui sharp sensor give distance bot eyrc track jbf szqnax jpg	transporter_bot
jbf13tyje7d60x	instruct time shipment	mam get follow detail track shipment pls tell time shipment receive kurukshetra college go nd pls tell shipment receive tomorrow way change receive place member city hope receive satisfiable answer	planter_bot
jbez726e3371px	component testing	instructor eyc havereceivedthe consignment successfully checklist battery mah battery mah castor wheel damage get base construct robot mention checklist instruct	planter_bot
jber5hxiudr584	hw testing doubt	upload hardware test planter bot	planter_bot
jbdvv4ct9mg68p	upload image	upload image okay instruct	planter_bot
jbdp4pgvdcu2eo	kit	status shipment show receive kanpur detail recieve college receive kit instruct 	planter_bot
jbdl6oqq9q5678	code uploading	tb able upload code firebird bootloader try time error get solve eyrc track jbdl xuzid jpg	transporter_bot
jbdhwjmke91xx	query task	image fine uploading require change	planter_bot
jbd15jnaif92d2	query shipment kit	 leader eyrc contact enter registration valid able edit eyantra portal courier person contact member receive reply soon possible	transporter_bot
jbckghxv8rf4cq	shipment	get shipment deadline hardware test th december kindly check 	planter_bot
jbci5o9oa4b4oc	doubt	upload image flex check ok good improvement require inform snap upload tomorrow 	planter_bot
jbc0ze2cgho274	robot kit doubt	unbox video planter bot say receive raspberry pi give tutorial atmega go work	planter_bot
jbby765uksv35a	hb flex printing	give size readme file cms file open dimension line width node length vary resize correct proportion hb	harvester_bot
jbbwmjlisl0dw	task result	get disqualify task recieve participation certificate	planter_bot
jbamfbx2dav5as	error uploading pic	madam try upload pic arena hrs time upload process complete till throw error check issue	planter_bot
jbameseoak13b	shipment address	 vacation uptil th dec get shipment update need know advance update reach college collect	transporter_bot
jba8hddzm7a3tk	date confirm acknowledgement robotic kit	try test robotic kit provide take time confirm th december	transporter_bot
jba5opgo94d56x	doubt shipment detail	wewere shortlist forstage unable open shipment detail blog open day need clarify andour theme isharvester bot	harvester_bot
jb9lswkxwkr4kj	color_marker	incolor_marker pdf different shape require print shape size seprately print wholecolor_marker pdf single size paper	planter_bot
jb9lnbsgqu6du	print flex	vendor open pdf file zoom ask set value print flex zoom okay instruction require instruct	planter_bot
jb9ljxr1gj32nz	flex	lin width describe inch tell line 	planter_bot
jb9lhpk9f465xp	planter_bot	eyrc planter bot receive kit status shipment detail	planter_bot
jb9kvxnont46p9	related shipment	 eyrc receive kit shipment detail blank	planter_bot
jb996jgd19v3m1	instructor email	provide instructor email contact detail urgent thank	transporter_bot
jb990mpskxt21u	arena glitch	arena design fine screenshot pdf file 	planter_bot
jb85r2vtta729o	photo upload	upload photo arena mention instruction shall uoload specific format	planter_bot
jb7wiaebl8k7c8	shipment bot	receive shipment receive way track 	harvester_bot
jb7taq9h4pv5av	justify	 code send guy work fine get comment output image csv check content	harvester_bot
jb7p3268ff434n	task file	 file task image file	transporter_bot
jb7ey550q3uh4	arena printing	line thickness cell line thickness start end point arena	planter_bot
jb6pytw9j9d5k2	shipment detail	require provide shipment detail yes provide instruct	planter_bot
jb6pv843bny2nb	flex	logo flex black white instead red color	planter_bot
jb6iokrlczv3bj	shipment acknlodgement press mistake	mistake press acknlodgement button receive component reset	planter_bot
jb6i4ym9f2c1kx	 arena print vinyl instead flex sheet	accordance rule karnataka government printing flex sheet ban bangalore vendor approach task refuse print flex sheet allow print planter_bot arena vinyl instead flex thank 	planter_bot
jb6fbwtllxk2v0	print flex sheet	hello madam assigned planter bot theme confusion printing arena print small grid give track true color exactly color lfr line slightly light intensity vendor want clear idea issue thank youin advanced	planter_bot
jb6f6idmn6q18q	shipment	revieve shipment college directly yes way know shipment reach college vacation right hrs journey collect parcel kindly 	planter_bot
jb69fwh72is6uy	shipment detail	shortlist stage able open blog fill shipment detail clarify asap	planter_bot
jb67ucz297x156	extention time	exam continue till week kindly extend time submission shall greatfull	planter_bot
jb5f1ni84pg2t7	robot shipment	shipment detail bot	planter_bot
jb4gxy5khlt1fv	task deadline	portal show task available th december deadline th december	harvester_bot
jb3t6oxbrqn67q	result mark mark award	complete code requirement run fine showing result mention task description planter bot theme require submit output image png format code give error program output image present folder code csv file input image png format get read program execute give different value color result code error think code give error execution mark get deduct task refer code execute output image folder consider code mark evaluation time consider request time run program test png image present folder	planter_bot
jb2lgohsar33ar	task result	result say solution ps- code process request time pc process input time screen shoot console input file processing time saving output require file 	transporter_bot
jb2izynpio04tz	question result	allow know mark detect problem present code future reference	planter_bot
jb2ea9f7lnf1hp	penalty	mam submit video submission date request extra time upload video internet connectivity little bit slow get response submit file submit video complete hour upload video get penalty total mark mam	transporter_bot
jb2a9oqgryrik	mistake result	 submit task minute deadline score code work bug task code fully functional task bug score possible remark code	planter_bot
jb271matw4w39j	score related	know error get	planter_bot
jb24lf2iiv47ek	task result	result say solution ps- code process request time pc process input time	transporter_bot
jb2438bfzfxsn	task result	submit task stage properly show task	planter_bot
jb23xsms75y1y2	task result	basis task evaluate actually get output code result show code incorrect	harvester_bot
jb227xizqdw6pt	mark basis	basis mark give successfully complete task correct result test case get mark	planter_bot
jb21ykgqh9q5t7	remark float div zero error undisclose set task	tell error occur basis score award	harvester_bot
jb20hjmmdai4vf	remark give task	throw error undisclose set image image program give error test program random image show correct result tell test image friendly testing	harvester_bot
jb1xzw5azm130f	congratulation	congratulation select stage go good luck	planter_bot
jb1utuhgqih4mv	feed form	question feed form finish task reply task completely	harvester_bot
javyjup5zpv3fz	task	task work design hardware design computer software	planter_bot
jaufr3payku4gt	task	task simulation computer involve workin hardware	planter_bot
jape1lu1uf65mi	small error	mam actually accidentally specify cv retr_external instead tree total contour section task video intend work normal condition wo work colored background mistake way change pls consider change know later unreleased video image 	planter_bot
jal42j8dziv24g	submission	upload task deadline correct change code upload folder consider deadline late folder	planter_bot
jakwi8lhmil55w	task doubt	expect overlap shape concentric circle appear testcase	planter_bot
jakw2zsyd8j68x	trouble understanding param videowriter	videowriter parameter outputpath size video create display image intendee nt appear outputpath size figure difference documentation show paramet outputpath fourcc fps size nt tell divx mjpg etc	planter_bot
jaksjfpci831lz	selection	solve statement create market place farm complete game time game python chance selection	transporter_bot
jakooxc8pc244b	task	line -return np uint cv addweighte face_part overlay_part follow error error operation array op array arrays size number channel array op scalar scalar op array function cv arithm_op sure height width channel image rectify error	planter_bot
jakls470mjf1t1	result task	result task declare	planter_bot
jakj5bfscg1k4	effect mark	create csv file task csv output come row effect mark	planter_bot
jak1369kcoc141	file size	upload file size zip file mb main file large ok upload google drive link	transporter_bot
jak0xrodsew4rd	file naming	description task mention output video name videooutput mp name video videooutput mp cause	planter_bot
jajytqsa6i4n7	file get upload	try upload file pm get follow error eyrc track jajyt ck jpg	planter_bot
jajwkmh09f2s8	wrong video trapezium cut	issue update video give task trapezium occur video cut error video code run successfully trapezium occur video check picture attach picture attach cut trapezium soon possible highly grateful kind act 	planter_bot
jajw4oxkanl3vh	late submission	submita day latea end semester exam go present allow submit late	harvester_bot
jajw1iji4cg3th	task	unable read video frame command ret frame cap read return value ret suppose true false fix issue relate task	planter_bot
jajvn8lcj2f1mb	maximum size google form upload task-	try upload task folder hrs try way compress folder mb 	transporter_bot
jajvcyus54f2dx	concatenate str int object	error comingcannot concatenate str int object use writecsv function	harvester_bot
jajuw0rc4bz3w8	query submission	 need edit code need rename code nee edit herefilep open result a_teamid csv nee rename csv file	harvester_bot
jajswwvs3h55or	task	add path video nt add path def main add path	planter_bot
jajsszr72uy3ee	task	task a_main py automatically import png image use cv imread mention cant't use cv imread function code work exactly ask read image variable	planter_bot
jajsrxy54d22w3	doubt submission task	output file contain python code automatically generate csv file output image test image contain output image csv file code test image reply soon possible	harvester_bot
jajq8c63tn7549	acknowledgement task submission	upload zip file get screen whatsapp_image pm jpeg eyantra website acknowledge video submission zip file upload work upload zip file	transporter_bot
jajnvc94hhr690	main fp	get error	planter_bot
jajnssdiqr75f9	content csv	column csv file task need display image path image default display path want display image nee edit edit portion display image name---- filep write fp change filep write os path basename fp currently displaying--- /downloads task /task a/ task_description test images\t png green rhombus- task write display--- test png green rhombus-	planter_bot
jajn7zz2eoh7kn	output	generate csv file task task 	planter_bot
jajlbpcgldi68	task error overlay image rhombus	get correct output overlay image figure rhombus produce errorerror operand broadcast shape eyrc track jajlaybfzm jpg	planter_bot
jajl2mla1ci3r3	pixel value bgr	shade blue green red respectively work	planter_bot
jajkkbia73c5zh	glitch video	work task download revise video glitch video overlay work fine point video nt	planter_bot
jajigeu12go3j4	related statement	actually texture visible blender render visible blender game engine	transporter_bot
jaji8okb5i22i7	grayscale image green red blue part image return jag line	gray png flower get overlay hexagon properly trapezoid appear run grayscale green part frame jag image	planter_bot
jajgmoc8cpj2pv	try overlay flower video create new frame	overlay frame overwrite original video use copy like frame frame copy frame frame video error fix	planter_bot
jaje890orar2o1	upload task	maa'm upload task correct folder name download submit file show different submit folder	planter_bot
jajds5cnphk2iv	overlay blend_transparent	blend_transparent face_img overlay_t_img function	planter_bot
jajboatljya40s	issue channel size	madam image provide channel image test program confirm number channel addweighte function face follow error error \opencv\modules\core\src\arithm cpp error operation array op array arrays size number channel array op scalar scalar op array function cv arithm_op resize image dimension provide set task thank	planter_bot
jaj5am7kce2368	video write task 	write video overlayed flower image remain stable keep flash remove try adjust cv waitkey timing help	planter_bot
jaj4z6prt9ira	contour task video	consider case contour repeat object pass rule overlay late object appear early video centriod shape size color considerthis case	planter_bot
jaj2l3ar8ae5og	file size	maximum size file upload	transporter_bot
jaj1fnu9kwe5sy	video error	task triangle red colour video detect trapezium try gaussian blur remove noise method contour detection resolve	planter_bot
jaj1dhhadbw1xk	statement	use key key mention bot key press bot simultaneously pick crate	transporter_bot
jaj15vrymrq796	submissiin	need change path submit simply need copy paste change	planter_bot
jaj0cnm0jwm65p	task def main video_file_with_path	def main video_file_with_path giving error tell write inside main place video_file_with_path	planter_bot
jaiyytmkcec16y	statement	write comment button bot game	transporter_bot
jaitq3ohdhk3e3	contour video task	video error detect extra contour error detect additional shape contour kindly	planter_bot
jaish1pahbjl4	task overlay flower image	document size overlay image mention size fine example acceptable	planter_bot
jaijzntgooy59d	task circle detect trapezium	task circle detect trapezium red circle come video detect red trapezium task successfully detect circle set th object frame detect circle trapezium overcome	planter_bot
jaihy3r0rq820e	frame skip task 	distortion decide skip frame time new shape come video cause overlay frame late upload video simply upload video skip frame size flower get halve distortion wil mark cut	planter_bot
jaigm2p1zz45hi	matplotlib	use matplotlib program library	planter_bot
jaieolyfo406g6	urgent error filedir	nameerror listdir define get error	harvester_bot
jaidgbtavav56l	csv error	get file output stop pls tell output image file	planter_bot
jaic5pn0z772y9	frame rate video length	try open video update vlc run time sec python try basic code opening video file print frame rate video frame rate accord note give ask use waitkey value waitkey value video length get reduce sec use waitkey value accord framerate video length sec 	planter_bot
jaibcrnsxdirb	task error	show error 	planter_bot
jai4fkdchj05rv	execute blend_transparent function show error	code output error come remove error	planter_bot
jai35ru0bn22s	video saving error	program end get error traceback recent file \users\hp\desktop\saurabh\maske py line module gray cv cvtcolor img cv color_bgr gray error \builds\master_packslaveaddon win -vc -static\opencv\modules\imgproc\src\color cpp error scn || scn function cv ipp_cvtcolor save video playing	planter_bot
jai2e3pcfl87o3	sample image task 	ok automatically read sample image testing code include image folder sample image requirement code let know soon hard code value size	harvester_bot
jai2drsmpu836g	error unindent match outer indentation level	small request get error multiple elif statement unindent match outer indentation level	planter_bot
jai1o656ftu5ba	find late contour video	task find late contour video add contour	planter_bot
jai19l5nhyl6hg	task video frame contain shape	video frame contain multiple triangle circle shape time	planter_bot
jai12gnr2kj52a	use contour	screenshot pngi able count contour cann't use contour take contours writingcontour give range	planter_bot
jahxpb22vu94zs	code call filenme nil task 	main path set directory contain test image main main path_to_video_mp file_with_name edit code task- b_main py mean path manually video mp process code video folder	planter_bot
jahwa3d3lf44o	request extend deadline	respect madam pressure unrelenting examination unable meet deadline specify th november complete task task need finish request extend deadline till th november immense completing task specify thank	planter_bot
jahw72cuyxq73u	doubt statement transporter bot	code work window ubuntu array character start window ubuntu character start code window time consume ubuntu fine upload file executable window	transporter_bot
jahvqp4lpstf	error task a_main py	code working seperately enter code write code section section csv file generate 	harvester_bot
jahs6rus2s244i	writecsv	use writecsv funtion use	planter_bot
jahquz0v1cg725	video upload harvester bot	instruction video upload task file download get email relate video upload asap	harvester_bot
jahlq2gpdkt7fj	read video	cap cv videocapture /video mp print cap isopene give false read video file	planter_bot
jahblnrk3ha3y	genrate csv file	program require output able genrate csv file have tounderstadne flow read image give output objecte shape time	planter_bot
jah8f18cm266sf	task function	allow wrap logic varioud function call main function	planter_bot
jah8dncos24g7	reference square image	code task different result different reference square image image code evaluate	planter_bot
jah308axeyj28m	task error	line fp onlyfilesp onlyfile neglect file file test png think onlyfile instead onlyfile edit	planter_bot
jah19wp95c334x	question task create list output	succesfully complete requirement task program return output image csv file task output video csv file task successfully list list structure specify task description fine change code theme planter bot	planter_bot
jah16ctlzj915m	blend_transparent function work	able generate frame find parameter resize picture overlap get follow additional error	planter_bot
jagzidmv97oh	convert grayscale consituent color	use cv cvtcolor color_gray bgr return image rgb channel rgb value alter return original color	planter_bot
jagyuhdyquf665	screen	basis screen evaluation happen	planter_bot
jagy80fsc6l3g	output video	complete code ioutput video play show error file play code cv videowriter videooutput avi cv videowriter_fourcc xvid	planter_bot
jaguyce8ppl6kx	code compilation window ubuntu	 teammate upload task window compile code ubuntu work properly code run window show error compulsory upload computer myteammate window upload code work ubuntu	planter_bot
jagu50gfqmj3v0	task output video	program work like image output video length second super fast original videothat sec set fps fps reason happen	planter_bot
jagt07puu9b6ul	pixel colour value	try pixel colour value pixel co ordinate return syntax colour img[cx cy print colour output- happen pixel suggest method pixel colour value	planter_bot
jagspfjhimp373	task cap isopene return false video present	title say error happen fix thank	planter_bot
jagqpsd8vn25oz	task 	respected madam able complete require processing task description link task- a_main py code cant't output color shape centroidx centroidy thank advance	planter_bot
jagpbbimh4e2f8	current object contour	current object contour appear frame	planter_bot
jago7rk5ndg1pv	color issue	color need test program early shape find blue paint bgr new video blue similar case green yellow range need check colorsfor task	planter_bot
jago232fa5n7f	task -a create output image	wesave test_output image path name different write description test png need create output image test output png save image time	planter_bot
jagkn8iolv719n	shoud code capable detect real life image	respect madam code working test image provide appye real life image throw error show output image question test code computer create image test real life image code work image code working	harvester_bot
jagj7apwhpv4sz	csv task	code run properly save correct output file csv file give require output	planter_bot
jagiu4jegck4zs	gettig error import image file	 size width size height function cv imshow	planter_bot
jaghjdni4zg5hp	shift centroid overlay img	hint shift overlay image position mean overlay flower img particular shape functon blend_transparent require image dimention	planter_bot
jaghbtrrb6636l	task overlay	overlay ok dimension flower little different show example task pdf mark cut overlay dimension flicker video skip cause trouble different dimension mark cut overlay	planter_bot
jaggy2zg6qq25u	content solution	mam submit video game problemsolution blend file solution folder uploading youtube sufficient final zip file size mb upload	transporter_bot
jaggw1u0o1d5yh	task	task get output input image send create image paint input code work use line load image code img cv imread sample png	planter_bot
jagg5cxbdek1kg	task compare test image sample image	matchtemplate function work re cv matchtemplate img_gray template cv tm_ccoeff_normed try size template nt clear idea compare test image	harvester_bot
jagegt197116ze	overlay	 say task description overlay centroid object image show vertical overlay cover half sided shape clear doubt want enquire follow overlay satisfactory comment task main code overlay rotate bounding rectangle	planter_bot
jagec3702ws4x5	collection library	okay use collection library create dictionary	harvester_bot
jage4su3wp2dp	task	maa'm hint detect present object appear frame contour approach fail require task	planter_bot
jagdhi80h156j4	task	test give shape shape like square rectangle test	planter_bot
jagd65u7ata7gh	broadcasting shape	show shape different size set size shape occur shape fluctuate little bit work perfectly shape	planter_bot
jagbm8c8dxu1hs	video compression	participant use vlc player compress output video mp mb unable programming step start vlc player medium tab menu call convert save select convert save tab file select output video click add button video show file selection list click convert save button menu screen menu subsection call setting profile dropdown select follow video mpeg tv device destination path want save video clicking browse type filename window pop indicate file ensure extension mp save type file box click save click start ensure video save fine check property play multiple video player good luck	planter_bot
jagbc3ggtxa5ua	task csv file file png come dot	eyrc track jagb wlsy jpgeyrc track jagbblkhyjva jpg	planter_bot
jagb9leyl4cc		detect current contour frame hint	planter_bot
jag9x2foody5r	sample image	large medium small size contour compulsory read sample image script read sample image separately use value area contour manually main script import script main script soon possible thank advance weimportsyslibrary area sample image available script	harvester_bot
jag9clkwzzm46o	flower imread	cv imread command behave differently different flower code read image_red cv imread overlay_image yellow_flower png image_blue cv imread overlay_image pink_flower png image_green cv imread overlay_image red_flower png happening	planter_bot
jag8lqtnqp65pa	error	get indent error output file get output run file sepratley	harvester_bot
jag8khsscme59n	task input video file	output mp hello mam task processing frame frame glitch second appear object overlay appear small size shape attach video output file tell okay mark deduct	planter_bot
jag8ghqvgfl10f	 task	mean imean unit specify	transporter_bot
jafrr1ovdp5369	discrepancy video set	late video set length side rhombus equal code mention rhombus trapezium center trapezium change slightly second result false reading tell	planter_bot
jafp9x29xem44i	submission	complete task video_output mp task folder size go mb compress zip compress mb instruct submit folder	planter_bot
jafocbuk4dj1jz	folder uploading	upload folder correct name format upload fole mail add end automatically statement right folder upload folder right evaluate concerned teamid	transporter_bot
jafkults50u4zo	remove overlay	remove overlay image nd shape appear video plz hint	planter_bot
jafj93kb1c23sk	attribute error occur	resolve traceback recent file \coding\task b\task b_main py line main ratio frame shape float frame shape attributeerror nonetype object attribute shape	planter_bot
jafismsbc3u5fv	contour task 	video instant shape hexagon trapezium get cut frame cause extras contour detect set overlay work fine code break point pls possible suggest way skip frame video maybe provide different video	planter_bot
jafhw9stcxt138	overlay flowes	size position flower overlay choice	planter_bot
jafhgrnu9ni2ww	undisclosed video	consider case new contour pop time	planter_bot
jafgzmlqkx95nq	error doubt	cnt cv findcontour thresh cv retr_external cv chain_approx_simple typeerror image numerical tuple debug error	planter_bot
jafbnja3blt1bk	error convert grayscale	get follow error time correction convert	planter_bot
jafbnbzov67ho	blend_transparent	blend_transparent function give error think alpha channel image try convert bgr overlay image channel	planter_bot
jafaooffg9r4z	alpha channel flower image provide	 wanted enquire flower image provide alpha channel create blend function give error overlay_mask follow code b_channel g_channel r_channel cv split overlay_image alpha_channel np one r_channel shape dtype b_channel dtype create dummy alpha channel image overlay_image cv merge b_channel g_channel r_channel alpha_channel	planter_bot
jaf9wrdbdu01mt	image task test png	test png image task pair rotate square width px height px question consider square rectangle	harvester_bot
jaf8zwgi77k8j	task	process frame frmae split video frame particular time process	planter_bot
jaf5zzpxj1113c	task	eyantra pdf file program pdf output error trying rectify long in't get valid resourse proper information rectify	planter_bot
jaf5ouvjpgh73t	task doubt	size object image vary	planter_bot
jaf4zrl96vc13	contour video task	video instant shape hexagon trapezium get cut frame cause extras contour detect effect mark	planter_bot
jaf4fbhqndn59z	advantage early submission thing	leader submit task th november code give desire output comment line code import matplotlib pyplot plt unintentionally effect rest program okay resubmit include previously comment line consider lose advantage early submission advantage early submission thank	harvester_bot
jaf40j6di8748	contour question	cnt cv findcontour thresh cv retr_tree cv chain_approx_simple cnt countour value boundary frame image boundary exist shape len cnt contour value find new contour boundary new shape come video available frame	planter_bot
